3 3 0 0 0 0 0 0 4 4 0 0 3 0 0 0 0 0 3 3
3 0 0 3 0 0 0 0 4 4 0 0 1 0 0 1 0 0 0 3
1 1 0 1 0 6 6 0 4 4 0 0 1 0 0 1 0 0 1 1
0 0 0 1 0 0 0 0 4 4 0 0 2 0 0 1 0 0 0 0
0 0 0 1 0 0 0 0 4 4 0 0 1 0 0 1 0 0 0 0
1 1 0 1 0 0 0 0 1 1 0 0 1 0 0 1 0 0 1 1
0 0 0 1 0 6 6 0 5 5 0 0 1 0 0 1 0 0 0 0
0 0 0 3 0 0 0 0 0 0 0 0 3 0 0 3 0 0 0 0
1 1 0 0 0 0 0 0 0 0 0 0 0 0 0 0 0 0 1 1
3 0 0 0 5 5 5 0 0 3 3 0 0 5 5 5 0 0 1 7
3 0 0 0 1 1 1 0 0 3 3 0 0 1 1 1 0 0 1 1
1 1 0 0 0 0 0 0 0 0 0 0 0 0 0 0 0 0 0 0
0 0 0 0 0 0 0 0 0 0 0 0 0 0 0 0 0 0 0 0
0 0 0 0 2 0 0 0 0 1 0 1 1 0 0 2 0 0 0 0
1 1 0 0 2 0 6 6 0 1 0 0 1 0 0 2 0 0 1 1
0 0 0 0 4 0 0 0 0 1 0 0 1 0 0 3 0 0 0 0
0 0 0 0 4 0 3 3 0 1 0 0 1 0 0 2 1 0 0 0
1 1 0 0 2 0 1 1 1 1 0 0 1 0 0 2 0 0 1 1
3 0 0 0 2 0 1 1 1 1 0 0 6 0 0 2 0 0 0 3
3 3 0 0 5 0 1 3 1 5 0 0 6 0 0 5 0 0 3 3
