3 3 3 3 3 3 3 3 3 3 3 3 3 3 3 3 3 3 3 3 
3 1 4 4 4 1 4 4 4 1 4 4 4 1 4 4 4 1 2 3 
3 4 4 4 4 4 4 4 4 2 4 4 4 4 4 4 4 4 2 3 
3 4 4 1 4 4 2 1 4 4 4 1 2 4 4 1 4 4 2 3 
3 4 4 4 4 4 4 4 4 2 4 4 4 4 4 4 4 4 2 3 
3 1 4 4 4 1 4 4 4 1 4 4 4 1 4 4 4 1 2 3 
3 4 4 2 4 4 2 4 4 2 4 4 2 4 4 2 4 4 2 3 
3 4 4 1 4 4 4 1 4 4 4 1 4 4 4 1 4 4 2 3 
3 4 4 4 4 4 4 4 4 2 4 4 4 4 4 4 4 4 2 3 
3 1 2 4 2 1 2 4 2 1 2 4 2 1 2 4 2 1 2 3 
3 4 4 4 4 4 4 4 4 2 4 4 4 4 4 4 4 4 2 3 
3 4 4 1 4 4 4 1 4 4 4 1 4 4 4 1 4 4 2 3 
3 4 4 2 4 4 2 4 4 2 4 4 2 4 4 2 4 4 2 3 
3 1 4 4 4 1 4 4 4 1 4 4 4 1 4 4 4 1 2 3 
3 4 4 4 4 4 4 4 4 2 4 4 4 4 4 4 4 4 2 3 
3 4 4 1 4 4 2 1 4 4 4 1 2 4 4 1 4 4 2 3 
3 4 4 4 4 4 4 4 4 2 4 4 4 4 4 4 4 4 2 3 
3 1 5 4 4 1 4 4 4 1 4 4 4 1 4 4 5 1 2 3 
3 2 2 2 2 2 2 2 2 2 2 2 2 2 2 2 2 2 2 3 
3 3 3 3 3 3 3 3 3 3 3 3 3 3 3 3 3 3 3 3 
